{
  "name" : "level_1",
  "height" : 10,
  "width" : 10,
  "field" : [["0", "0", "0", "0", "0", "0", "0", "0", "0", "0"],
             ["0", "0", "0", "0", "0", "0", "0", "0", "0", "0"],
             ["0", "0", "0", "0", "0", "0", "0", "0", "0", "0"],
             ["0", "0", "0", "0", "0", "0", "0", "0", "0", "0"],
             ["0", "0", "0", "0", "0", "0", "0", "0", "0", "0"],
             ["0", "0", "0", "0", "0", "0", "0", "0", "0", "0"],
             ["0", "f", "0", "0", "0", "0", "0", "0", "0", "0"],
             ["0", "1", "0", "0", "0", "0", "0", "0", "0", "0"],
             ["0", "0", "0", "0", "0", "0", "0", "0", "0", "0"],
             ["0", "s", "0", "0", "0", "0", "0", "0", "0", "0"]]
}